1,1
42,17
WWWWWWWWWWWWWWWWWWWWWWWWWWWWWWWWWWWWWWWWWW
G3333333333333333333333333333333333333333W
G3333333333333333333333333333333333333333W
G3333333333333333333333333333333333333333W
G3333333333333333333333333333333333333333W
G3333333333333333333333333333333333333333W
G33333333333333333g3333333333333333333333W
G3333333333333333333333333333333333333333W
G3333333333333333333333333333333333333333W
G3333333333333333333333333333333333333333W
G3333333333333333333333333333333333333333W
G3333333333333333333333333333333333333333W
G3333333333333333333333333333333333333333W
G3333333333333333333333333333333333333333W
G3333333333333333333333333333333333333333W
G3333333333333333333333333333333333333333W
GGGGGGGGGGGGGGGGGGGGGGGGGGGGGGGGGGGGGGGGGG