1,9
44,17
3,3;24,3;21,13
39,3
OGGGGGGGGGGGGGGGGGGGGGGGGGGGGGGGGGGGGGGGGGGO
OG111111111W222222222W11111111111W11111111GO
OG111111111W222222222W11111111111W11111111GO
OG111111111W222222222W11111111111W11111111GO
OG111111111W222222222W11111111111W11111111GO
OG111111111W222222222W11111111111W11111111GO
OGWWWW11WWWWWWWW22WWWWWWWWW11WWWWWWWW11WWWGO
O333333333333333333333333333333333333333333O
O333333333333333333333333333333333333333333O
O333333333333333333333333333333333333333333O
OGWW22WWWW11WWWWWWWWWWWWWWWWWWWWW22WWWWWWWGO
OG22222W1111111111W4444444W222222222222222GO
OG22222W1111111111W44444442222222222222222GO
OG22222W1111111111W44444442222222222222222GO
OG22222W1111111111W4444444W222222222222222GO
OG22222W1111111111W4444444W222222222222222GO
OGGGGGGGGGGGGGGGGGGGGGGGGGGGGGGGGGGGGGGGGGGO

--------------------------------------------
------------P--S-S----------------NNNNNNNN--
----E----------E-E----------------NNNNNNEN--
----------------------------------NNNNNNNN--
----------------------------------NNNFNNNN--
----------------------------------NNNNNNNN--
------cc--------cc---------cc--------cc-----
--------------------------------------------
--------------------------------------------
--------------------------------------------
----cc----cc---------------------cc---------
------------S-S----------E----P-----S-S-S---
--E---------E-E-----------C---------E-E-E---
---F--T-------------------C-----------------
----N-------S-S-------------------S-S-S-S---
--N--N------E-E-------------------E-E-E-E---
--------------------------------------------

--------------------------------------------
--------------------------------------------
----L----------C-C----------------------C---
--------------------------------------------
--------------------------------------------
--------------------------------------------
--------------------------------------------
--------------------------------------------
--------------------------------------------
--------------------------------------------
--------------------------------------------
--------------------------------------------
--L---------C-C---------------------C-C-C---
--------------------------------------------
--------------------------------------------
------------C-C-------------------C-C-C-C---
--------------------------------------------