1,1
42,17
WWWWWWWWWWWWWWWWWWWWWWWWWWWWWWWWWWWWWWWWWW
G111111111111111W111111111111111111111111W
G222222222222222W222222222222222222222222W
G3333333333333333333333333333333333333333W
G4444444444444444444444444444444444444444W
G555555555555555W555555555555555555555555W
G555555555555555W555555555555555555555555W
G444444444444444WWWWWWWWWWWWWWWWWWWWWWWWWW
G33333333333333333333333333333333333333333
G22222222222222222222222222222222222222222
G111111111111111WWWWWWWWWWW11WWWWWWWWWWWWW
G111111111111111W111111111111111111111111W
G222222222222222W222222222222222222222222W
G333333333333333W333333333333333333333333W
G444444444444444W444444444444444444444444W
G555555555555555W555555555555555555555555W
GGGGGGGGGGGGGGGGGGGGGGGGGGGGGGGGGGGGGGGGGG