25,2
50,36
15,3;48,12;2,30
3,3
OOOOOOOOOOOOOOOOOOOOOOOOOOOOOOOOOOOOOOOOOOOOOOOOOO
GGGGGGGGGGGGGGGGGGGGGGGG11GGGGGGGGGGGGGGGGGGGGGGGG
G1111111111W1111111111111111111111111111111111111G
G1111111111W1111111111111111111111111111111111111G
G1111111111W11111111111W11W1111111111111111111111G
G1111111111W11111111111W11W1111111111111111111111G
G1111111111W11111111111W11W1111111111111111111111G
G1111111111W11111111111W11W1111111111111111111111G
G1111111111W11111111111W11W1111111111111111111111G
G1111111111W11111111111W11W1111111111111111111111G
G1111111111W11111111111W11W1111111111111111111111G
G1111111111W11111111111W11W1111111111111111111111G
G1111111111W11111111111W11W1111111111111111111111G
G1111111111W11111111111W11W1111111111111111111111G
G1111111111W11111111111W11W1111111111111111111111G
G1111111111111111111111W11W1111111111111111111111G
G1111111111111111111111W11W1111111111111111111111G
GWWWWWWWW11WWWWWWWWWWWWW11W1111111111111111111111G
G1111111111111111111111W11W1111111111111111111111G
G1111111111111111111111W11W1111111111111111111111G
G1111111111111111111111W11W1111111111111111111111G
G1111111111111111111111W11W1111111111111111111111G
G1111111111111111111111W11W1111111111111111111111G
G1111111111111111111111W11W1111111111111111111111G
G1111111111111111111111W11W1111111111111111111111G
G1111111111111111111111W11W1111111111111111111111G
G1111111111111111111111W11W1111111111111111111111G
G1111111111111111111111W11W1111111111111111111111G
G1111111111111111111111W11W1111111111111111111111G
G1111111111111111111111W11W1111111111111111111111G
G1111111111111111111111W11W1111111111111111111111G
G1111111111111111111111W11W1111111111111111111111G
G111111111111111111111111111111111111111111111111G
G111111111111111111111111111111111111111111111111G
GGGGGGGGGGGGGGGGGGGGGGGG11GGGGGGGGGGGGGGGGGGGGGGGG
OOOOOOOOOOOOOOOOOOOOOOOOOOOOOOOOOOOOOOOOOOOOOOOOOO

--------------------------------------------------
--------------------------------------------------
--------------------------------------------------
-S----------------------------------------------S-
-E----------------------------------------------E-
--------------------------------------------------
--------------------------------------------------
--------------------------------------------------
--------------------------------------------------
---------------------------------------------F----
--------------------------------------------------
--------------------------------------------------
--------------------------------------------------
--------------------------------------------------
--------------------------------------------------
--------------------------------------------------
--------------------------------------------------
--------------------------------------------------
--------------------------------------------------
--------------------------------------------------
--------------------------------------------------
--------------------------------------------------
--------------------------------------------------
--------------------------------------------------
--------------------------------------------------
--------------------------------------------------
--------------------------------------------------
--------------------------------------------------
--------------------------------------------------
--------------------------------------------------
--------------------------------------------------
--------------------------------------------------
----------------P---------------------------------
--------------------------------------------------
--F-----------------------------------------------
--------------------------------------------------

--------------------------------------------------
--------------------------------------------------
--------------------------------------------------
--------------------------------------------------
-C----------------------------------------------C-
--------------------------------------------------
--------------------------------------------------
--------------------------------------------------
--------------------------------------------------
--------------------------------------------------
--------------------------------------------------
--------------------------------------------------
--------------------------------------------------
--------------------------------------------------
--------------------------------------------------
--------------------------------------------------
--------------------------------------------------
--------------------------------------------------
--------------------------------------------------
--------------------------------------------------
--------------------------------------------------
--------------------------------------------------
--------------------------------------------------
--------------------------------------------------
--------------------------------------------------
--------------------------------------------------
--------------------------------------------------
--------------------------------------------------
--------------------------------------------------
--------------------------------------------------
--------------------------------------------------
--------------------------------------------------
--------------------------------------------------
--------------------------------------------------
--------------------------------------------------
--------------------------------------------------
