1,1
43,17
20,2;2,2;20,13
1,15
WWWWWWWWWWWWWWWWWWWWWWWWWWWWWWWWWWWWWWWWWWO
G111111111111111W555555555555555555555555WO
G111111111111111W555555555555555555555555WO
G1111111111111111555555555555555555555555WO
G1111111111111111555555555555555555555555WO
G111111111111111W555555555555555555555555WO
G111111111111111W555555555555555555555555WO
G111111111111111WWWWWWWWWWWWWWWWWWWWWWWWWWO
G11111111111111111111111111111111111111111O
G11111111111111111111111111111111111111111O
G111111111111111WWWWWWWWWWW11WWWWWWWWWWWWWO
G111111111111111W333333333333333333333333WO
G111111111111111W333333333333333333333333WO
G111111111111111W333333333333333333333333WO
G111111111111111W333333333333333333333333WO
G111111111111111W333333333333333333333333WO
GGGGGGGGGGGGGGGGGGGGGGGGGGGGGGGGGGGGGGGGGGO

-------------------------------------------
----E--------------------------------------
-------------------------------------------
-------------P--C------------F----T-N------
----------------C------------------N-------
-T-NN--------------------------------------
-------------------------------------------
-E----N---------C--------------------------
----------------C--------------------------
---------------------------cc--------------
------F---------------E--------------------
-------------------------------P-----------
--------------------------T----------------
------------------------------------N------
------S------E--------------------T--------
-------------------------------------------
-------------------------------------------

-------------------------------------------
----P--------------------------------------
-------------------------------------------
-------------------------------------------
-------------------------------------------
-------------------------------------------
-------------------------------------------
-P-----------------------------------------
-------------------------------------------
-------------------------------------------
----------------------L--------------------
-------------------------------------------
-------------------------------------------
-------------------------------------------
-------------------------------------------
-------------------------------------------
-------------------------------------------