1,1
43,17
WWWWWWWWWWWWWWWWWWWWWWWWWWWWWWWWWWWWWWWWWWO
G111111111111111W111111111111111111111111WO
G222222222222222W222222222222222222222222WO
G3333333333333333333333333333333333333333WO
G4444444444444444444444444444444444444444WO
G555555555555555W555555555555555555555555WO
G555555555555555W555555555555555555555555WO
G444444444444444WWWWWWWWWWWWWWWWWWWWWWWWWWO
G33333333333333333333333333333333333333333O
G22222222222222222222222222222222222222222O
G111111111111111WWWWWWWWWWW11WWWWWWWWWWWWWO
G111111111111111W111111111111111111111111WO
G222222222222222W222222222222222222222222WO
G333333333333333W333333333333333333333333WO
G444444444444444W444444444444444444444444WO
G555555555555555W555555555555555555555555WO
GGGGGGGGGGGGGGGGGGGGGGGGGGGGGGGGGGGGGGGGGGO

-------------------------------------------
----EE-------------------------------------
----EE-------------------------------------
-------------P--D------------F----TTN------
----------------D------------------N-------
-TTNN--------------------------------------
-------------------------------------------
-EESSPN---------C--------------------------
----------------C--------------------------
---------------------------CD--------------
------F--------------EE--------------------
------------------------------PP-----------
-------------------------TT----------------
-----------------------------F-----NN------
------SS----EE-------------------TT--------
-------------------------------------------
-------------------------------------------

-------------------------------------------
----PC-------------------------------------
----LN-------------------------------------
-------------------------------------------
-------------------------------------------
-------------------------------------------
-------------------------------------------
-P-----------------------------------------
-------------------------------------------
-------------------------------------------
----------------------L--------------------
-------------------------------------------
-------------------------------------------
-------------------------------------------
------------C------------------------------
-------------------------------------------
-------------------------------------------